,p,p_1,odds,score,no_of_alerts,true_alerts,FPR,TPR,FN,TN,FP,TP,percentage,no_of_alerts_mon,no_of_alerts_days,perc_alerts,perc_savings,type2error,False_alert,FTE_costs,Mis_costs,Tot_costs,Per_of_Current_Cost,,
1,0.9999,1.00E-04,9999,1006,0,0,0,0,4207,4163,0,0,0,0,0,0,1,0.58205,28,0,736225,736225,7.329998009,,
2,0.9949,0.0051,195.0784314,779,0,0,0,0,4207,4163,0,0,0,0,0,0,1,0.5716,28,0,736225,736225,7.329998009,,
3,0.9899,0.0101,98.00990099,739,0,0,0,0,4207,4163,0,0,0,0,0,0,1,0.56115,28,0,736225,736225,7.329998009,,
4,0.9849,0.0151,65.22516556,715,0,0,0,0,4207,4163,0,0,0,0,0,0,1,0.5507,28,0,736225,736225,7.329998009,,
5,0.9799,0.0201,48.75124378,699,0,0,0,0,4207,4163,0,0,0,0,0,0,1,0.54025,28,0,736225,736225,7.329998009,,
6,0.9749,0.0251,38.84063745,685,0,0,0,0,4207,4163,0,0,0,0,0,0,1,0.5298,28,0,736225,736225,7.329998009,,
7,0.9699,0.0301,32.22259136,675,12,8,0.000960846,0.001901593,4199,4159,4,8,0,1,0,0.001194743,0.998805257,0.51935,27.94675541,144,734825,734969,7.317493031,,
8,0.9649,0.0351,27.49002849,665,12,8,0.000960846,0.001901593,4199,4159,4,8,0,1,0,0.001194743,0.998805257,0.5089,27.94675541,144,734825,734969,7.317493031,,
9,0.9599,0.0401,23.93765586,657,12,8,0.000960846,0.001901593,4199,4159,4,8,0,1,0,0.001194743,0.998805257,0.49845,27.94675541,144,734825,734969,7.317493031,,
10,0.9549,0.0451,21.172949,650,24,16,0.001921691,0.003803185,4191,4155,8,16,0,2,0,0.002389486,0.997610514,0.488,27.89351082,288,733425,733713,7.304988053,,
11,0.9499,0.0501,18.96007984,644,36,22,0.003362959,0.00522938,4185,4149,14,22,0,4,0,0.004778973,0.995221027,0.47755,27.85357737,432,732375,732807,7.295967742,,
12,0.9449,0.0551,17.14882033,638,36,22,0.003362959,0.00522938,4185,4149,14,22,0,4,0,0.004778973,0.995221027,0.4671,27.85357737,432,732375,732807,7.295967742,,
13,0.9399,0.0601,15.63893511,633,36,22,0.003362959,0.00522938,4185,4149,14,22,0,4,0,0.004778973,0.995221027,0.45665,27.85357737,432,732375,732807,7.295967742,,
14,0.9349,0.0651,14.3609831,628,36,22,0.003362959,0.00522938,4185,4149,14,22,0,4,0,0.004778973,0.995221027,0.4462,27.85357737,432,732375,732807,7.295967742,,
15,0.9299,0.0701,13.26533524,623,36,22,0.003362959,0.00522938,4185,4149,14,22,0,4,0,0.004778973,0.995221027,0.43575,27.85357737,432,732375,732807,7.295967742,,
16,0.9249,0.0751,12.31557923,619,36,22,0.003362959,0.00522938,4185,4149,14,22,0,4,0,0.004778973,0.995221027,0.4253,27.85357737,432,732375,732807,7.295967742,,
17,0.9199,0.0801,11.48439451,615,36,22,0.003362959,0.00522938,4185,4149,14,22,0.005,4,0,0.004778973,0.995221027,0.41485,27.85357737,432,732375,732807,7.295967742,,
18,0.9149,0.0851,10.75088132,611,48,28,0.004804228,0.006655574,4179,4143,20,28,0.01,5,0,0.005973716,0.994026284,0.4044,27.81364393,576,731325,731901,7.286947431,,
19,0.9099,0.0901,10.09877913,608,48,28,0.004804228,0.006655574,4179,4143,20,28,0.015,5,0,0.005973716,0.994026284,0.39395,27.81364393,576,731325,731901,7.286947431,,
20,0.9049,0.0951,9.515247108,604,48,28,0.004804228,0.006655574,4179,4143,20,28,0.02,5,0,0.005973716,0.994026284,0.3835,27.81364393,576,731325,731901,7.286947431,,
21,0.8999,0.1001,8.99000999,601,48,28,0.004804228,0.006655574,4179,4143,20,28,0.025,5,0,0.005973716,0.994026284,0.37305,27.81364393,576,731325,731901,7.286947431,,
22,0.8949,0.1051,8.514747859,598,48,28,0.004804228,0.006655574,4179,4143,20,28,0.03,5,0,0.005973716,0.994026284,0.3626,27.81364393,576,731325,731901,7.286947431,,
23,0.8899,0.1101,8.082652134,595,60,32,0.006725919,0.00760637,4175,4135,28,32,0.035,6,0,0.007168459,0.992831541,0.35215,27.78702163,720,730625,731345,7.281411788,,
24,0.8849,0.1151,7.688097307,592,60,32,0.006725919,0.00760637,4175,4135,28,32,0.04,6,0,0.007168459,0.992831541,0.3417,27.78702163,720,730625,731345,7.281411788,,
25,0.8799,0.1201,7.326394671,589,60,32,0.006725919,0.00760637,4175,4135,28,32,0.045,6,0,0.007168459,0.992831541,0.33125,27.78702163,720,730625,731345,7.281411788,,
26,0.8749,0.1251,6.993605116,586,60,32,0.006725919,0.00760637,4175,4135,28,32,0.05,6,0,0.007168459,0.992831541,0.3208,27.78702163,720,730625,731345,7.281411788,,
27,0.8699,0.1301,6.686395081,584,60,32,0.006725919,0.00760637,4175,4135,28,32,0.055,6,0,0.007168459,0.992831541,0.31035,27.78702163,720,730625,731345,7.281411788,,
28,0.8649,0.1351,6.4019245,581,60,32,0.006725919,0.00760637,4175,4135,28,32,0.06,6,0,0.007168459,0.992831541,0.2999,27.78702163,720,730625,731345,7.281411788,,
29,0.8599,0.1401,6.137758744,579,72,39,0.007926976,0.009270264,4168,4130,33,39,0.065,7,0,0.008363202,0.991636798,0.28945,27.74043261,864,729400,730264,7.270649144,,
30,0.8549,0.1451,5.891798759,577,84,45,0.009368244,0.010696458,4162,4124,39,45,0.07,8,0,0.009557945,0.990442055,0.279,27.70049917,1008,728350,729358,7.261628833,,
31,0.8499,0.1501,5.662225183,574,84,45,0.009368244,0.010696458,4162,4124,39,45,0.075,8,0,0.009557945,0.990442055,0.26855,27.70049917,1008,728350,729358,7.261628833,,
32,0.8449,0.1551,5.447453256,572,157,88,0.016574586,0.020917518,4119,4094,69,88,0.08,16,1,0.01911589,0.98088411,0.2581,27.41430948,1884,720825,722709,7.195430108,,
33,0.8399,0.1601,5.24609619,570,213,122,0.021859236,0.028999287,4085,4072,91,122,0.085,21,1,0.025089606,0.974910394,0.24765,27.18801997,2556,714875,717431,7.142881322,,
34,0.8349,0.1651,5.056935191,568,270,142,0.030747057,0.033753268,4065,4035,128,142,0.09,27,1,0.032258065,0.967741935,0.2372,27.05490849,3240,711375,714615,7.114844683,,
35,0.8299,0.1701,4.878894768,566,350,192,0.037953399,0.045638222,4015,4005,158,192,0.095,35,1,0.04181601,0.95818399,0.22675,26.72212978,4200,702625,706825,7.037285942,,
36,0.8249,0.1751,4.711022273,564,397,215,0.043718472,0.051105301,3992,3981,182,215,0.1,40,1,0.047789725,0.952210275,0.2163,26.56905158,4764,698600,703364,7.002827559,,
37,0.8199,0.1801,4.55247085,562,482,251,0.05548883,0.059662467,3956,3932,231,251,0.105,48,2,0.05734767,0.94265233,0.20585,26.32945092,5784,692300,698084,6.950258861,,
38,0.8149,0.1851,4.402485143,560,535,273,0.062935383,0.064891847,3934,3901,262,273,0.11,54,2,0.064516129,0.935483871,0.1954,26.18302829,6420,688450,694870,6.918259658,,
39,0.8099,0.1901,4.260389269,558,614,314,0.072063416,0.074637509,3893,3863,300,314,0.115,61,2,0.072879331,0.927120669,0.19395,25.91014975,7368,681275,688643,6.856262445,,
40,0.8049,0.1951,4.125576627,556,665,337,0.078789335,0.080104588,3870,3835,328,337,0.12,66,2,0.078853047,0.921146953,0.1925,25.75707155,7980,677250,685230,6.822281959,,
41,0.7999,0.2001,3.997501249,554,731,371,0.086476099,0.088186356,3836,3803,360,371,0.125,73,2,0.087216249,0.912783751,0.19105,25.53078203,8772,671300,680072,6.770927917,,
42,0.7949,0.2051,3.875670405,552,818,411,0.097766034,0.097694319,3796,3756,407,411,0.13,82,3,0.097968937,0.902031063,0.1896,25.26455907,9816,664300,674116,6.711628833,,
43,0.7899,0.2101,3.759638267,551,908,460,0.107614701,0.109341574,3747,3715,448,460,0.135,91,3,0.108721625,0.891278375,0.18815,24.93843594,10896,655725,666621,6.637007168,,
44,0.7849,0.2151,3.649000465,549,983,493,0.117703579,0.117185643,3714,3673,490,493,0.14,98,3,0.117084827,0.882915173,0.1867,24.718802,11796,649950,661746,6.588470729,,
45,0.7799,0.2201,3.543389368,547,1029,513,0.123949075,0.121939624,3694,3647,516,513,0.145,103,3,0.123058542,0.876941458,0.18525,24.58569052,12348,646450,658798,6.559119873,,
46,0.7749,0.2251,3.442470013,546,1102,561,0.12995436,0.13334918,3646,3622,541,561,0.15,110,4,0.131421744,0.868578256,0.1838,24.26622296,13224,638050,651274,6.484209478,,
47,0.7699,0.2301,3.345936549,544,1206,610,0.143165986,0.144996435,3597,3567,596,610,0.155,121,4,0.144563919,0.855436081,0.18235,23.94009983,14472,629475,643947,6.411260454,,
48,0.7649,0.2351,3.253509145,542,1263,639,0.149891905,0.151889708,3568,3539,624,639,0.16,126,4,0.150537634,0.849462366,0.1809,23.74708819,15156,624400,639556,6.367542812,,
49,0.7599,0.2401,3.164931279,541,1343,677,0.159980783,0.160922272,3530,3497,666,677,0.165,134,4,0.160095579,0.839904421,0.17945,23.49417637,16116,617750,633866,6.310892075,,
50,0.7549,0.2451,3.07996736,539,1392,702,0.165745856,0.166864749,3505,3473,690,702,0.17,139,5,0.166069295,0.833930705,0.178,23.32778702,16704,613375,630079,6.273187973,,
51,0.7499,0.2501,2.99840064,538,1535,777,0.182080231,0.18469218,3430,3405,758,777,0.175,154,5,0.183990442,0.816009558,0.17655,22.82861897,18420,600250,618670,6.15959777,,
52,0.7449,0.2551,2.92003136,536,1616,816,0.192169109,0.193962444,3391,3363,800,816,0.18,162,5,0.193548387,0.806451613,0.1751,22.56905158,19392,593425,612817,6.101324174,,
53,0.7399,0.2601,2.844675125,535,1741,877,0.207542638,0.208462087,3330,3299,864,877,0.185,174,6,0.207885305,0.792114695,0.17365,22.16306156,20892,582750,603642,6.009976105,,
54,0.7349,0.2651,2.772161449,533,1925,968,0.229882296,0.230092703,3239,3206,957,968,0.19,192,6,0.229390681,0.770609319,0.1722,21.55740433,23100,566825,589925,5.873407009,,
55,0.7299,0.2701,2.702332469,532,2076,1036,0.249819841,0.24625624,3171,3123,1040,1036,0.195,208,7,0.248506571,0.751493429,0.17075,21.10482529,24912,554925,579837,5.772968937,,
56,0.7249,0.2751,2.635041803,530,2211,1094,0.268316118,0.260042786,3113,3046,1117,1094,0.2,221,7,0.264038232,0.735961768,0.1693,20.718802,26532,544775,571307,5.688042613,,
57,0.7199,0.2801,2.570153517,529,2337,1161,0.28248859,0.275968624,3046,2987,1176,1161,0.205,234,8,0.279569892,0.720430108,0.16785,20.27287854,28044,533050,561094,5.586360016,,
58,0.7149,0.2851,2.507541214,527,2538,1259,0.307230363,0.299263133,2948,2884,1279,1259,0.21,254,8,0.303464755,0.696535245,0.1664,19.62063228,30456,515900,546356,5.439625647,,
59,0.7099,0.2901,2.447087211,526,2696,1342,0.325246217,0.318992156,2865,2809,1354,1342,0.215,270,9,0.322580645,0.677419355,0.16495,19.06821963,32352,501375,533727,5.313888889,,
60,0.7049,0.2951,2.388681803,524,2819,1411,0.338217632,0.335393392,2796,2755,1408,1411,0.22,282,9,0.336917563,0.663082437,0.1635,18.60898502,33828,489300,523128,5.208363202,,
61,0.6999,0.3001,2.332222592,523,2975,1492,0.356233485,0.354647017,2715,2680,1483,1492,0.225,298,10,0.356033453,0.643966547,0.16205,18.06988353,35700,475125,510825,5.085872162,,
62,0.6949,0.3051,2.277613897,522,3124,1569,0.373528705,0.372949845,2638,2608,1555,1569,0.23,312,10,0.372759857,0.627240143,0.1606,17.55740433,37488,461650,499138,4.969514138,,
63,0.6899,0.3101,2.224766204,520,3295,1652,0.394667307,0.392678869,2555,2520,1643,1652,0.235,330,11,0.394265233,0.605734767,0.15915,17.00499168,39540,447125,486665,4.845330546,,
64,0.6849,0.3151,2.173595684,519,3387,1699,0.40547682,0.403850725,2508,2475,1688,1699,0.24,339,11,0.405017921,0.594982079,0.1577,16.6921797,40644,438900,479544,4.774432497,,
65,0.6799,0.3201,2.124023743,518,3592,1804,0.429497958,0.428809128,2403,2375,1788,1804,0.245,359,12,0.428912784,0.571087216,0.15625,15.99334443,43104,420525,463629,4.615979689,,
66,0.6749,0.3251,2.075976623,516,3664,1837,0.438866202,0.436653197,2370,2336,1827,1837,0.25,366,12,0.437275986,0.562724014,0.1548,15.77371048,43968,414750,458718,4.567084827,,
67,0.6699,0.3301,2.029385035,515,3688,1848,0.44198895,0.439267887,2359,2323,1840,1848,0.255,369,12,0.440860215,0.559139785,0.15335,15.70049917,44256,412825,457081,4.550786539,,
68,0.6649,0.3351,1.984183826,514,3724,1866,0.446312755,0.44354647,2341,2305,1858,1866,0.26,372,12,0.444444444,0.555555556,0.1519,15.58069884,44688,409675,454363,4.523725607,,
69,0.6599,0.3401,1.940311673,512,3760,1885,0.450396349,0.448062753,2322,2288,1875,1885,0.265,376,13,0.449223417,0.550776583,0.15045,15.45424293,45120,406350,451470,4.494922342,,
70,0.6549,0.3451,1.897710808,511,3796,1899,0.455680999,0.45139054,2308,2266,1897,1899,0.27,380,13,0.454002389,0.545997611,0.149,15.36106489,45552,403900,449452,4.474830745,,
71,0.6499,0.3501,1.856326764,510,3868,1932,0.465049243,0.459234609,2275,2227,1936,1932,0.275,387,13,0.462365591,0.537634409,0.14755,15.14143095,46416,398125,444541,4.425935882,,
72,0.6449,0.3551,1.816108139,509,3928,1967,0.471054528,0.467554077,2240,2202,1961,1967,0.28,393,13,0.46953405,0.53046595,0.1461,14.90848586,47136,392000,439136,4.37212266,,
73,0.6399,0.3601,1.777006387,507,4012,2010,0.480903195,0.477775137,2197,2161,2002,2010,0.285,401,13,0.479091995,0.520908005,0.14465,14.62229617,48144,384475,432619,4.307238152,,
74,0.6349,0.3651,1.738975623,506,4048,2034,0.483785731,0.483479914,2173,2149,2014,2034,0.29,405,14,0.483870968,0.516129032,0.1432,14.4625624,48576,380275,428851,4.269723218,,
75,0.6299,0.3701,1.70197244,505,4168,2095,0.497958203,0.497979558,2112,2090,2073,2095,0.295,417,14,0.498207885,0.501792115,0.14175,14.05657238,50016,369600,419616,4.177777778,,
76,0.6249,0.3751,1.665955745,504,4216,2121,0.503242854,0.504159734,2086,2068,2095,2121,0.3,422,14,0.504181601,0.495818399,0.1403,13.88352745,50592,365050,415642,4.138211868,,
77,0.6199,0.3801,1.630886609,502,4300,2168,0.512130675,0.51533159,2039,2031,2132,2168,0.305,430,14,0.513739546,0.486260454,0.13885,13.57071547,51600,356825,408425,4.066358025,,
78,0.6149,0.3851,1.596728123,501,4504,2262,0.538553927,0.537675303,1945,1921,2242,2262,0.31,450,15,0.537634409,0.462365591,0.1374,12.94509151,54048,340375,394423,3.926951414,,
79,0.6099,0.3901,1.56344527,500,4648,2331,0.556569781,0.554076539,1876,1846,2317,2331,0.315,465,16,0.555555556,0.444444444,0.13595,12.48585691,55776,328300,384076,3.823934687,,
80,0.6049,0.3951,1.531004809,499,4840,2427,0.579630074,0.57689565,1780,1750,2413,2427,0.32,484,16,0.578255675,0.421744325,0.1345,11.8469218,58080,311500,369580,3.679609717,,
81,0.5999,0.4001,1.499375156,498,5080,2546,0.608695652,0.60518184,1661,1629,2534,2546,0.325,508,17,0.60692951,0.39307049,0.13305,11.05490849,60960,290675,351635,3.500945838,,
82,0.5949,0.4051,1.46852629,496,5332,2664,0.640883978,0.63323033,1543,1495,2668,2664,0.33,533,18,0.636798088,0.363201912,0.1316,10.26955075,63984,270025,334009,3.325457985,,
83,0.5899,0.4101,1.438429651,495,5524,2767,0.662262791,0.657713335,1440,1406,2757,2767,0.335,552,18,0.659498208,0.340501792,0.13015,9.584026622,66288,252000,318288,3.168936679,,
84,0.5849,0.4151,1.409058058,494,5596,2798,0.672111458,0.665082006,1409,1365,2798,2798,0.34,560,19,0.669056153,0.330943847,0.1287,9.377703827,67152,246575,313727,3.123526483,,
85,0.5799,0.4201,1.380385622,493,5764,2874,0.694210906,0.683147136,1333,1273,2890,2874,0.345,576,19,0.688172043,0.311827957,0.12725,8.8718802,69168,233275,302443,3.011180804,,
86,0.5749,0.4251,1.352387673,492,5932,2956,0.714869085,0.70263846,1251,1187,2976,2956,0.35,593,20,0.708482676,0.291517324,0.1258,8.326123128,71184,218925,290109,2.888381123,,
87,0.5699,0.4301,1.325040688,490,6004,2987,0.724717752,0.710007131,1220,1146,3017,2987,0.355,600,20,0.716845878,0.283154122,0.12435,8.119800333,72048,213500,285548,2.842970928,,
88,0.5649,0.4351,1.298322225,489,6076,3024,0.73312515,0.718801997,1183,1111,3052,3024,0.36,608,20,0.726403823,0.273596177,0.1229,7.873544093,72912,207025,279937,2.78710673,,
89,0.5599,0.4401,1.272210861,488,6148,3056,0.742733606,0.726408367,1151,1071,3092,3056,0.365,615,20,0.734767025,0.265232975,0.12145,7.660565724,73776,201425,275201,2.739954202,,
90,0.5549,0.4451,1.246686138,487,6220,3096,0.75042037,0.73591633,1111,1039,3124,3096,0.37,622,21,0.743130227,0.256869773,0.12,7.394342762,74640,194425,269065,2.678863003,,
91,0.5499,0.4501,1.221728505,486,6292,3131,0.759308191,0.744235797,1076,1002,3161,3131,0.375,629,21,0.751493429,0.248506571,0.11855,7.161397671,75504,188300,263804,2.626483473,,
92,0.5449,0.4551,1.19731927,485,6412,3192,0.773480663,0.758735441,1015,943,3220,3192,0.38,641,21,0.765830346,0.234169654,0.1171,6.755407654,76944,177625,254569,2.534538033,,
93,0.5399,0.4601,1.173440556,483,6508,3241,0.784770598,0.770382696,966,896,3267,3241,0.385,651,22,0.777777778,0.222222222,0.11565,6.429284526,78096,169050,247146,2.460633214,,
94,0.5349,0.4651,1.150075253,482,6568,3272,0.791736728,0.777751367,935,867,3296,3272,0.39,657,22,0.784946237,0.215053763,0.1142,6.22296173,78816,163625,242441,2.413789327,,
95,0.5299,0.4701,1.127206977,481,6640,3317,0.798222436,0.788447825,890,840,3323,3317,0.395,664,22,0.793309438,0.206690562,0.11275,5.923460899,79680,155750,235430,2.34398646,,
96,0.5249,0.4751,1.104820038,480,6700,3341,0.806870046,0.794152603,866,804,3359,3341,0.4,670,22,0.800477897,0.199522103,0.1113,5.763727121,80400,151550,231950,2.309338909,,
97,0.5199,0.4801,1.082899396,479,6784,3385,0.816478501,0.804611362,822,764,3399,3385,0.405,678,23,0.810035842,0.189964158,0.10985,5.470881864,81408,143850,225258,2.242712067,,
98,0.5149,0.4851,1.061430633,478,6820,3404,0.820562095,0.809127644,803,747,3416,3404,0.41,682,23,0.814814815,0.185185185,0.1084,5.344425957,81840,140525,222365,2.213908801,,
99,0.5099,0.4901,1.040399918,477,6880,3436,0.827288013,0.816734015,771,719,3444,3436,0.415,688,23,0.821983274,0.178016726,0.10695,5.131447587,82560,134925,217485,2.165322581,,
100,0.5049,0.4951,1.019793981,475,6880,3436,0.827288013,0.816734015,771,719,3444,3436,0.42,688,23,0.821983274,0.178016726,0.1055,5.131447587,82560,134925,217485,2.165322581,,
101,0.4999,0.5001,0.99960008,474,6916,3457,0.830891184,0.821725695,750,704,3459,3457,0.425,692,23,0.826762246,0.173237754,0.10405,4.991680532,82992,131250,214242,2.133034648,,
102,0.4949,0.5051,0.979805979,473,6976,3488,0.837857314,0.829094367,719,675,3488,3488,0.43,698,23,0.833930705,0.166069295,0.1026,4.785357737,83712,125825,209537,2.086190761,,
103,0.4899,0.5101,0.960399922,472,7024,3513,0.843382176,0.835036843,694,652,3511,3513,0.435,702,23,0.838709677,0.161290323,0.10115,4.618968386,84288,121450,205738,2.048367184,,
104,0.4849,0.5151,0.941370608,471,7060,3534,0.846985347,0.840028524,673,637,3526,3534,0.44,706,24,0.84348865,0.15651135,0.0997,4.479201331,84720,117775,202495,2.016079251,,
105,0.4799,0.5201,0.922707172,470,7084,3544,0.850348307,0.842405515,663,623,3540,3544,0.445,708,24,0.845878136,0.154121864,0.09825,4.412645591,85008,116025,201033,2.001523297,,
106,0.4749,0.5251,0.904399162,468,7132,3571,0.855392746,0.84882339,636,602,3561,3571,0.45,713,24,0.851851852,0.148148148,0.0968,4.232945092,85584,111300,196884,1.960215054,,
107,0.4699,0.5301,0.886436521,467,7168,3590,0.859476339,0.853339672,617,585,3578,3590,0.455,717,24,0.856630824,0.143369176,0.09535,4.106489185,86016,107975,193991,1.931411788,,
108,0.4649,0.5351,0.868809568,466,7252,3630,0.87004564,0.862847635,577,541,3622,3630,0.46,725,24,0.866188769,0.133811231,0.09155,3.840266223,87024,100975,187999,1.871754281,,
109,0.4599,0.5401,0.85150898,465,7312,3656,0.878212827,0.869027811,551,507,3656,3656,0.465,731,24,0.873357228,0.126642772,0.08775,3.667221298,87744,96425,184169,1.833622063,,
110,0.4549,0.5451,0.834525775,464,7336,3671,0.88037473,0.872593297,536,498,3665,3671,0.47,734,24,0.876941458,0.123058542,0.08395,3.567387687,88032,93800,181832,1.81035444,,
111,0.4499,0.5501,0.8178513,463,7420,3725,0.887581071,0.885429047,482,468,3695,3725,0.475,742,25,0.886499403,0.113500597,0.08015,3.207986689,89040,84350,173390,1.726304261,,
112,0.4449,0.5551,0.801477211,461,7480,3750,0.89598847,0.891371524,457,433,3730,3750,0.48,748,25,0.893667861,0.106332139,0.07635,3.041597338,89760,79975,169735,1.689914377,,
113,0.4399,0.5601,0.785395465,460,7504,3762,0.898871006,0.894223913,445,421,3742,3762,0.485,750,25,0.896057348,0.103942652,0.07255,2.961730449,90048,77875,167923,1.671873755,,
114,0.4349,0.5651,0.769598301,459,7504,3762,0.898871006,0.894223913,445,421,3742,3762,0.49,750,25,0.896057348,0.103942652,0.06955,2.961730449,90048,77875,167923,1.671873755,,
115,0.4299,0.5701,0.754078232,458,7528,3775,0.901513332,0.897314,432,410,3753,3775,0.495,753,25,0.899641577,0.100358423,0.06655,2.875207987,90336,75600,165936,1.6520908,,
116,0.4249,0.5751,0.73882803,457,7588,3802,0.909440307,0.903731875,405,377,3786,3802,0.5,759,25,0.906810036,0.093189964,0.06355,2.695507488,91056,70875,161931,1.612216249,,
117,0.4199,0.5801,0.723840717,456,7648,3833,0.916406438,0.911100547,374,348,3815,3833,0.505,765,26,0.913978495,0.086021505,0.06055,2.489184692,91776,65450,157226,1.565372362,,
118,0.4149,0.5851,0.709109554,454,7684,3849,0.921210665,0.914903732,358,328,3835,3849,0.51,768,26,0.917562724,0.082437276,0.05755,2.382695507,92208,62650,154858,1.541796097,,
119,0.4099,0.5901,0.694628029,453,7696,3854,0.922892145,0.916092227,353,321,3842,3854,0.515,770,26,0.91995221,0.08004779,0.05455,2.349417637,92352,61775,154127,1.53451812,,
120,0.4049,0.5951,0.68038985,452,7732,3871,0.927456161,0.920133111,336,302,3861,3871,0.52,773,26,0.92353644,0.07646356,0.05155,2.236272879,92784,58800,151584,1.509199522,,
121,0.3999,0.6001,0.666388935,451,7756,3884,0.930098487,0.923223199,323,291,3872,3884,0.525,776,26,0.927120669,0.072879331,0.04935,2.149750416,93072,56525,149597,1.489416567,,
122,0.3949,0.6051,0.652619402,450,7792,3901,0.934662503,0.927264084,306,272,3891,3901,0.53,779,26,0.930704898,0.069295102,0.04715,2.036605657,93504,53550,147054,1.464097969,,
123,0.3899,0.6101,0.639075561,448,7828,3916,0.939706942,0.93082957,291,251,3912,3916,0.535,783,26,0.935483871,0.064516129,0.04565,1.936772047,93936,50925,144861,1.442264038,,
124,0.3849,0.6151,0.62575191,447,7840,3923,0.940907999,0.932493463,284,246,3917,3923,0.54,784,26,0.936678614,0.063321386,0.04415,1.890183028,94080,49700,143780,1.431501394,,
125,0.3799,0.6201,0.612643122,446,7876,3946,0.944030747,0.937960542,261,233,3930,3946,0.545,788,26,0.941457587,0.058542413,0.04265,1.737104825,94512,45675,140187,1.395728793,,
126,0.3749,0.6251,0.599744041,445,7888,3951,0.945712227,0.939149037,256,226,3937,3951,0.55,789,26,0.94265233,0.05734767,0.04115,1.703826955,94656,44800,139456,1.388450816,,
127,0.3699,0.6301,0.587049675,444,7900,3957,0.947153495,0.940575232,250,220,3943,3957,0.555,790,26,0.943847073,0.056152927,0.03965,1.663893511,94800,43750,138550,1.379430506,,
128,0.3649,0.6351,0.574555188,442,7900,3957,0.947153495,0.940575232,250,220,3943,3957,0.56,790,26,0.943847073,0.056152927,0.03815,1.663893511,94800,43750,138550,1.379430506,,
129,0.3599,0.6401,0.562255898,441,7960,3991,0.953398991,0.948657,216,194,3969,3991,0.565,796,27,0.951015532,0.048984468,0.03665,1.437603993,95520,37800,133320,1.327359618,,
130,0.3549,0.6451,0.550147264,440,7996,4015,0.956281528,0.954361778,192,182,3981,4015,0.57,800,27,0.955794504,0.044205496,0.03515,1.277870216,95952,33600,129552,1.289844683,,
131,0.3499,0.6501,0.538224888,438,8008,4023,0.957242373,0.956263371,184,178,3985,4023,0.575,801,27,0.956989247,0.043010753,0.03425,1.224625624,96096,32200,128296,1.277339705,,
132,0.3449,0.6551,0.526484506,437,8080,4060,0.965649772,0.965058236,147,143,4020,4060,0.58,808,27,0.965352449,0.034647551,0.03335,0.978369384,96960,25725,122685,1.221475508,,
133,0.3399,0.6601,0.514921982,436,8092,4065,0.967331252,0.966246732,142,136,4027,4065,0.585,809,27,0.966547192,0.033452808,0.03245,0.945091514,97104,24850,121954,1.214197531,,
134,0.3349,0.6651,0.503533303,435,8104,4071,0.96877252,0.967672926,136,130,4033,4071,0.59,810,27,0.967741935,0.032258065,0.03155,0.90515807,97248,23800,121048,1.20517722,,
135,0.3299,0.6701,0.49231458,433,8116,4079,0.969733365,0.969574519,128,126,4037,4079,0.595,812,27,0.970131422,0.029868578,0.03065,0.851913478,97392,22400,119792,1.192672242,,
136,0.3249,0.6751,0.481262035,432,8152,4094,0.974777804,0.973140005,113,105,4058,4094,0.6,815,27,0.973715651,0.026284349,0.02975,0.752079867,97824,19775,117599,1.170838311,,
137,0.3199,0.6801,0.470372004,431,8176,4109,0.976939707,0.976705491,98,96,4067,4109,0.605,818,27,0.977299881,0.022700119,0.02885,0.652246256,98112,17150,115262,1.147570689,,
138,0.3149,0.6851,0.459640928,429,8176,4109,0.976939707,0.976705491,98,96,4067,4109,0.61,818,27,0.977299881,0.022700119,0.02795,0.652246256,98112,17150,115262,1.147570689,,
139,0.3099,0.6901,0.449065353,428,8188,4116,0.978140764,0.978369384,91,91,4072,4116,0.615,819,27,0.978494624,0.021505376,0.02735,0.605657238,98256,15925,114181,1.136808045,,
140,0.3049,0.6951,0.438641922,427,8224,4135,0.982224357,0.982885667,72,74,4089,4135,0.62,822,27,0.982078853,0.017921147,0.02675,0.479201331,98688,12600,111288,1.108004779,,
141,0.2999,0.7001,0.428367376,425,8236,4143,0.983185203,0.984787259,64,70,4093,4143,0.625,824,27,0.984468339,0.015531661,0.02615,0.425956739,98832,11200,110032,1.095499801,,
142,0.2949,0.7051,0.418238548,424,8236,4143,0.983185203,0.984787259,64,70,4093,4143,0.63,824,27,0.984468339,0.015531661,0.02555,0.425956739,98832,11200,110032,1.095499801,,
143,0.2899,0.7101,0.408252359,423,8236,4143,0.983185203,0.984787259,64,70,4093,4143,0.635,824,27,0.984468339,0.015531661,0.02495,0.425956739,98832,11200,110032,1.095499801,,
144,0.2849,0.7151,0.398405817,421,8260,4156,0.985827528,0.987877347,51,59,4104,4156,0.64,826,28,0.986857826,0.013142174,0.02435,0.339434276,99120,8925,108045,1.075716846,,
145,0.2799,0.7201,0.388696014,420,8260,4156,0.985827528,0.987877347,51,59,4104,4156,0.645,826,28,0.986857826,0.013142174,0.02375,0.339434276,99120,8925,108045,1.075716846,,
146,0.2749,0.7251,0.379120121,418,8272,4164,0.986788374,0.98977894,43,55,4108,4164,0.65,827,28,0.988052569,0.011947431,0.02335,0.286189684,99264,7525,106789,1.063211868,,
147,0.2699,0.7301,0.369675387,417,8272,4164,0.986788374,0.98977894,43,55,4108,4164,0.655,827,28,0.988052569,0.011947431,0.02295,0.286189684,99264,7525,106789,1.063211868,,
148,0.2649,0.7351,0.360359135,415,8272,4164,0.986788374,0.98977894,43,55,4108,4164,0.66,827,28,0.988052569,0.011947431,0.02255,0.286189684,99264,7525,106789,1.063211868,,
149,0.2599,0.7401,0.351168761,414,8284,4166,0.989190488,0.990254338,41,45,4118,4166,0.665,828,28,0.989247312,0.010752688,0.02215,0.272878536,99408,7175,106583,1.061160892,,
150,0.2549,0.7451,0.342101731,412,8284,4166,0.989190488,0.990254338,41,45,4118,4166,0.67,828,28,0.989247312,0.010752688,0.02175,0.272878536,99408,7175,106583,1.061160892,,
151,0.2499,0.7501,0.333155579,411,8284,4166,0.989190488,0.990254338,41,45,4118,4166,0.675,828,28,0.989247312,0.010752688,0.02115,0.272878536,99408,7175,106583,1.061160892,,
152,0.2449,0.7551,0.324327904,409,8284,4166,0.989190488,0.990254338,41,45,4118,4166,0.68,828,28,0.989247312,0.010752688,0.0208,0.272878536,99408,7175,106583,1.061160892,,
153,0.2399,0.7601,0.315616366,408,8284,4166,0.989190488,0.990254338,41,45,4118,4166,0.685,828,28,0.989247312,0.010752688,0.02045,0.272878536,99408,7175,106583,1.061160892,,
154,0.2349,0.7651,0.30701869,406,8284,4166,0.989190488,0.990254338,41,45,4118,4166,0.69,828,28,0.989247312,0.010752688,0.0201,0.272878536,99408,7175,106583,1.061160892,,
155,0.2299,0.7701,0.298532658,404,8284,4166,0.989190488,0.990254338,41,45,4118,4166,0.695,828,28,0.989247312,0.010752688,0.01975,0.272878536,99408,7175,106583,1.061160892,,
156,0.2249,0.7751,0.290156109,403,8284,4166,0.989190488,0.990254338,41,45,4118,4166,0.7,828,28,0.989247312,0.010752688,0.0194,0.272878536,99408,7175,106583,1.061160892,,
157,0.2199,0.7801,0.281886938,401,8296,4171,0.990871967,0.991442833,36,38,4125,4171,0.705,830,28,0.991636798,0.008363202,0.01905,0.239600666,99552,6300,105852,1.053882915,,
158,0.2149,0.7851,0.273723093,399,8308,4178,0.992073024,0.993106727,29,33,4130,4178,0.71,831,28,0.992831541,0.007168459,0.0187,0.193011647,99696,5075,104771,1.043120271,,
159,0.2099,0.7901,0.265662574,398,8308,4178,0.992073024,0.993106727,29,33,4130,4178,0.715,831,28,0.992831541,0.007168459,0.01835,0.193011647,99696,5075,104771,1.043120271,,
160,0.2049,0.7951,0.257703434,396,8308,4178,0.992073024,0.993106727,29,33,4130,4178,0.72,831,28,0.992831541,0.007168459,0.018,0.193011647,99696,5075,104771,1.043120271,,
161,0.1999,0.8001,0.24984377,394,8320,4185,0.993274081,0.99477062,22,28,4135,4185,0.725,832,28,0.994026284,0.005973716,0.01765,0.146422629,99840,3850,103690,0.53,,
162,0.1949,0.8051,0.242081729,392,8332,4191,0.99471535,0.996196815,16,22,4141,4191,0.73,833,28,0.995221027,0.004778973,0.0172,0.106489185,99984,2800,102784,1.023337316,,
163,0.1899,0.8101,0.234415504,391,8332,4191,0.99471535,0.996196815,16,22,4141,4191,0.735,833,28,0.995221027,0.004778973,0.01675,0.106489185,99984,2800,102784,1.023337316,,
164,0.1849,0.8151,0.226843332,389,8332,4191,0.99471535,0.996196815,16,22,4141,4191,0.74,833,28,0.995221027,0.004778973,0.0163,0.106489185,99984,2800,102784,1.023337316,,
165,0.1799,0.8201,0.219363492,387,8332,4191,0.99471535,0.996196815,16,22,4141,4191,0.745,833,28,0.995221027,0.004778973,0.01585,0.106489185,99984,2800,102784,1.023337316,,
166,0.1749,0.8251,0.211974306,385,8344,4195,0.996637041,0.997147611,12,14,4149,4195,0.75,834,28,0.996415771,0.003584229,0.0154,0.079866889,100128,2100,102228,1.017801673,,
167,0.1699,0.8301,0.204674136,383,8344,4195,0.996637041,0.997147611,12,14,4149,4195,0.755,834,28,0.996415771,0.003584229,0.01495,0.079866889,100128,2100,102228,1.017801673,,
168,0.1649,0.8351,0.197461382,381,8344,4195,0.996637041,0.997147611,12,14,4149,4195,0.76,834,28,0.996415771,0.003584229,0.0145,0.079866889,100128,2100,102228,1.017801673,,
169,0.1599,0.8401,0.190334484,379,8344,4195,0.996637041,0.997147611,12,14,4149,4195,0.765,834,28,0.996415771,0.003584229,0.01405,0.079866889,100128,2100,102228,1.017801673,,
170,0.1549,0.8451,0.183291918,376,8344,4195,0.996637041,0.997147611,12,14,4149,4195,0.77,834,28,0.996415771,0.003584229,0.0136,0.079866889,100128,2100,102228,1.017801673,,
171,0.1499,0.8501,0.176332196,374,8344,4195,0.996637041,0.997147611,12,14,4149,4195,0.775,834,28,0.996415771,0.003584229,0.01315,0.079866889,100128,2100,102228,0.63,,
172,0.1449,0.8551,0.169453865,372,8344,4195,0.996637041,0.997147611,12,14,4149,4195,0.78,834,28,0.996415771,0.003584229,0.0127,0.079866889,100128,2100,102228,1.017801673,,
173,0.1399,0.8601,0.162655505,369,8344,4195,0.996637041,0.997147611,12,14,4149,4195,0.785,834,28,0.996415771,0.003584229,0.01225,0.079866889,100128,2100,102228,1.017801673,,
174,0.1349,0.8651,0.15593573,367,8344,4195,0.996637041,0.997147611,12,14,4149,4195,0.79,834,28,0.996415771,0.003584229,0.0118,0.079866889,100128,2100,102228,1.017801673,,
175,0.1299,0.8701,0.149293185,364,8344,4195,0.996637041,0.997147611,12,14,4149,4195,0.795,834,28,0.996415771,0.003584229,0.01135,0.079866889,100128,2100,102228,1.017801673,,
176,0.1249,0.8751,0.142726546,362,8356,4200,0.99831852,0.998336106,7,7,4156,4200,0.8,836,28,0.998805257,0.001194743,0.0109,0.046589018,100272,1225,101497,1.010523696,,
177,0.1199,0.8801,0.136234519,359,8356,4200,0.99831852,0.998336106,7,7,4156,4200,0.805,836,28,0.998805257,0.001194743,0.01045,0.046589018,100272,1225,101497,1.010523696,,0.00045
178,0.1149,0.8851,0.12981584,356,8356,4200,0.99831852,0.998336106,7,7,4156,4200,0.81,836,28,0.998805257,0.001194743,0.01,0.046589018,100272,1225,101497,1.010523696,,
179,0.1099,0.8901,0.123469273,354,8356,4200,0.99831852,0.998336106,7,7,4156,4200,0.815,836,28,0.998805257,0.001194743,0.00955,0.046589018,100272,1225,101497,1.010523696,,
180,0.1049,0.8951,0.11719361,351,8356,4200,0.99831852,0.998336106,7,7,4156,4200,0.82,836,28,0.998805257,0.001194743,0.0091,0.046589018,100272,1225,101497,1.010523696,,
181,0.0999,0.9001,0.110987668,347,8356,4200,0.99831852,0.998336106,7,7,4156,4200,0.825,836,28,0.998805257,0.001194743,0.00865,0.046589018,100272,1225,101497,1.010523696,,
182,0.0949,0.9051,0.104850293,344,8356,4200,0.99831852,0.998336106,7,7,4156,4200,0.83,836,28,0.998805257,0.001194743,0.0082,0.046589018,100272,1225,101497,1.010523696,,
183,0.0899,0.9101,0.098780354,341,8356,4200,0.99831852,0.998336106,7,7,4156,4200,0.835,836,28,0.998805257,0.001194743,0.00775,0.046589018,100272,1225,101497,1.010523696,,
184,0.0849,0.9151,0.092776746,337,8356,4200,0.99831852,0.998336106,7,7,4156,4200,0.84,836,28,0.998805257,0.001194743,0.0073,0.046589018,100272,1225,101497,1.010523696,,
185,0.0799,0.9201,0.086838387,333,8356,4200,0.99831852,0.998336106,7,7,4156,4200,0.85,836,28,0.998805257,0.001194743,0.00685,0.046589018,100272,1225,101497,1.010523696,,
186,0.0749,0.9251,0.08096422,329,8356,4200,0.99831852,0.998336106,7,7,4156,4200,0.86,836,28,0.998805257,0.001194743,0.0064,0.046589018,100272,1225,101497,0.87,,
187,0.0699,0.9301,0.075153209,325,8356,4200,0.99831852,0.998336106,7,7,4156,4200,0.87,836,28,0.998805257,0.001194743,0.00595,0.046589018,100272,1225,101497,1.010523696,,
188,0.0649,0.9351,0.069404342,320,8356,4200,0.99831852,0.998336106,7,7,4156,4200,0.88,836,28,0.998805257,0.001194743,0.0055,0.046589018,100272,1225,101497,1.010523696,,
189,0.0599,0.9401,0.063716626,315,8356,4200,0.99831852,0.998336106,7,7,4156,4200,0.89,836,28,0.998805257,0.001194743,0.00505,0.046589018,100272,1225,101497,1.010523696,,
190,0.0549,0.9451,0.058089091,310,8356,4200,0.99831852,0.998336106,7,7,4156,4200,0.9,836,28,0.998805257,0.001194743,0.0046,0.046589018,100272,1225,101497,1.010523696,,
191,0.0499,0.9501,0.052520787,304,8356,4200,0.99831852,0.998336106,7,7,4156,4200,0.91,836,28,0.998805257,0.001194743,0.00415,0.046589018,100272,1225,101497,1.010523696,,
192,0.0449,0.9551,0.047010784,298,8356,4200,0.99831852,0.998336106,7,7,4156,4200,0.92,836,28,0.998805257,0.001194743,0.0037,0.046589018,100272,1225,101497,1.010523696,,
193,0.0399,0.9601,0.041558171,291,8356,4200,0.99831852,0.998336106,7,7,4156,4200,0.93,836,28,0.998805257,0.001194743,0.00325,0.046589018,100272,1225,101497,1.010523696,,
194,0.0349,0.9651,0.036162056,283,8356,4200,0.99831852,0.998336106,7,7,4156,4200,0.94,836,28,0.998805257,0.001194743,0.0028,0.046589018,100272,1225,101497,1.010523696,,
195,0.0299,0.9701,0.030821565,273,8356,4200,0.99831852,0.998336106,7,7,4156,4200,0.95,836,28,0.998805257,0.001194743,0.00235,0.046589018,100272,1225,101497,1.010523696,,
196,0.0249,0.9751,0.025535842,263,8356,4200,0.99831852,0.998336106,7,7,4156,4200,0.96,836,28,0.998805257,0.001194743,0.0019,0.046589018,100272,1225,101497,1.010523696,,
197,0.0199,0.9801,0.020304051,249,8370,4207,1,1,0,0,4163,4207,0.97,837,28,1,0,0.00145,0,100440,0,100440,1,,
198,0.0149,0.9851,0.015125368,232,8370,4207,1,1,0,0,4163,4207,0.98,837,28,1,0,0.001,0,100440,0,100440,1,,
199,0.0099,0.9901,0.00999899,208,8370,4207,1,1,0,0,4163,4207,0.99,837,28,1,0,0.00055,0,100440,0,100440,1,,
200,0.0049,0.9951,0.004924128,168,8370,4207,1,1,0,0,4163,4207,1,837,28,1,0,1E-04,0,100440,0,100440,1,,
